EG	Palestine
لما بقابل موظف حكومه محترم ببقي عايز ابوس راسه والله	Egypt
تصدقي يا ندى انا مش بحبها دمها تقيل و مش حلوة ولا حاجة دي تقيلة اوي	Egypt
حب النادى حاجه . .. والمنتخب حاجه تانية . .. بس الحقيقة الموازيين عندنا متشقلبة . .. ولا انتا مش معايا	Egypt
اعتقد ان رفع الدعم عن رغيف العيش لن يناقشه احد ولا حتى فى خياله . ..ده عيش . .عارفين يعنى ايه عيش بالنسبة للمصريين . ..ده ممكن يبقى الوجبة الوحيدة اللى بيسد بها الغلبان جوعه . ...	Egypt
مبروك يا أعظم لاعب في تاريخ مصر . . فرحتك و كل إنجاز ليك اللي بيخلوا بكل المصريين فرحانين من قلبهم خلوك أسطورة مش هتتكرر . ..  #محمد_صلاح	Egypt
---------	Palestine
DZ	Palestine
الله يعزك ويعلي قدرك وشانك ختيتو يارب وانت وخولة من أطيب الاشخاص الموجدين هنا ربي يحفظكم ويعطيكم كل لي تتمناوه يارب	Algeria
مارهوش يحاولك فيك باه تنتخبي انت حرة في اختيارك ولي رايحين ينتخبوه هم احرار	Algeria
ايه علابالي وللاسف الواقع ماولاش فيه رحمة . .. مبصح حدود الله ولا يحق لنا تجاوزها	Algeria
نظن عارفين ان العريس مايجيش بهاذ الطريقة لكن الكبت و النقص العاطفي يخليهم يديرو هكا باش تلحقهم كلمة مجاملة الكترونية	Morocco
والله انت طلعت اصيل اكثر منها عملتلي بلوك لان انصح فيها واش راكي رافدة يابلادي	Algeria
----------	Palestine
SD	Yemen
بريد شنو يا بتاع الفته بالرز ان شالله تكون غيرتو جو كويس بحر دار كيف بالله	Sudan
أنا مافتحته خشمي دا ولا قلته اي شي باالعكس قلته ل مونت ماصح كده ياخ ههههه	Sudan
انا متابع مع شبابنا الهناك وما بكتب حاجة الا هم يقولوا لي اكتبها ومستنين الصباح عشان نمشي ندعمهم . .	Egypt
الحاصل عندهم دا اصلا مطبوخ من خروج محمد علي الي ان يستلم الجيش البلد ياعم الشعب شحدو شحدة وشجعو عشان ينزل .	Sudan
الزول دة ماعندوا بلد فيها مشاكل والله مرتاح وفاض	Sudan
-----------	Palestine
IQ	Palestine
اني البارحة اول مرة اسمعة من كثر ما اسمع العالم تحجي بي كلت شو خل اسمعة طلع يعني حلو	Iraq
اذا انت هيج خوش ما فتحت ابواب جهنم على البعثيه وداعش وحررت الموصل صار اكثر من شهر ؟ شو الانبار صار NUM اشهر ما فتحت . ..	Iraq
اتركو تهمة البعث البعث انقبر واي حزب تسقط دولته ينتهي التهمة صارت شماعة والله تعلكون بيها فشلكم وع القناة انا هم أشوفها بدأت تفشل من جابت سوالف الضحك التافهة بس مو بعثية	Iraq
مرحت اهلي وخليت اختي تدرس اهلي طب اسنان واني رحت حكومي . .. ما اعتبرهه تضحيه ابد بس الناس هيج تكول يعني	Iraq
ع كولتك ، مو مال يتويوب وع فكرة يوتيوب همين هالايام تسمح بكلشي مو مثل قبل . .خربانين	Iraq
-------------	Palestine
MA	Palestine
ديك الضصارة اللي كادير فالريال سير كولها . .دوزتها لك على وجه هد الشيباني إنييستا	Morocco
سوء تدبير الشأن الوطني من قبل سياسة صيبيانية للخدام دولة خلات بلد على محك ملي غادي تقود نييت غادي كل واحد اشد طيارة و يهرب	Morocco
منعم عندو مايقول شاعر مبتدأ هو وعروستو زوينين ومحترمين ومقبولين هههههههه قتلني ديال الرباط بالضحك	Morocco
كيتاصلو بيك ويقولو ليك راك ربحتي معانا واحد معنا مبلغ مالي ، كيقولو ليك عطيني سميتك والعنوان وكيطلبو ليك ارقام NUM تعبئات NUM درهم بلاحشمة وبلا حيا	Morocco
تبحت عن من يعطيها درس في بزااف الامور اعتقد هدى متخلفة معرفاش بلي في تونس هناك إداعة راديو لشواد عندهم وقانون يحمي ويجوز لهم ممارسة مثل ها الامور الاخت بزاف معلومات في بلادها معرفهاش ايلا بغات نعاود لها القراية	Morocco
------------	Palestine
SA	Kuwait
مايقهروني غير البنوك يربطون اقلامهم بحبل الحين حنا واثقين فيكم وحاطين كل فلوسنا عندكم وانتوا مو واثقين فينا بقلم ب ريال " ̮ رجعو فلوسي بس = )	Qatar
احنا بالجنوب تهامة عسير احس الديره اليوم الجو مره براااااااااد الحمدلله كان حررر يذبح ورطووووووبه	Kuwait
عسى الله يطول عمار اللي يمشون في هواها . . فالكم الخير يبو سعود وعلمونا بمحلكم نسير عليكم	Kuwait
اتمنى يجلدونه قدام البيت اللي اطلق عليه النار ويطلقون عليه بعد كم رصاصه بس للتخويف عشان يعرف المهايطي ان الله حق	Saudi-Arabia
لو يقفلون النادي للموسم الجاي ابرك  من زين هاتمارين الي ماتفيد بالمباريات  لاعبين فاااشلين حتي نهاية الهجمه مايعرفونها	Saudi-Arabia
-----------	Palestine
YE	Palestine
يا ليت محد يسألني إيش جديدك لأن حياتي تنسخ اللي حصل أمس و تلصقه كل يوم .	Libya
إن بغيت تكون فرحي هاك صدريٰ  وإن بغيت تكون حزني . . مأيخالف .	Morocco
إن بغيت تكون فرحي هاك صدريٰ  وإن بغيت تكون حزني . . مأيخالف .	Morocco
مدخلتو في مواجهه جت التعليمات عدم المواجهة اكلتوو الطعم اهم شي	Libya
إنتا من اول قاعد تقول كلام حلو وبديت اهداء وكل شيء صار كويس وخربتها الحين ب ماله الحق في تكبير الموضوع  انا الحين بنسى كل الكلام ورح تمسك ببالي هالكلمة	Palestine
---------	Palestine
SY	Palestine
يا اخي يلعن ابو الصنف اللي عم تتعاطاه ركز شوي ولما بتكون ضارب شي لاتفتح تويتر وتكتب	Lebanon
حاج تمجدو بهل الحكام كلون اسقط من بعض ما بيهمون غير هالكرسي و انتو بطبلو ألون	Lebanon
ماتفكر حالك شايف كلشي #ببلادنا_بتشوف اللي ما شفتو . ومفكر تشوفو .	Syria
شوف قديش نحن متفقين شقفة منتخب قالها بصوت عالي انه مع بشار #الأسد  واحد معارض ببرر لحاله انه الرياضة مادخلها . ..	Syria
العمى ضرب جوز عيونو اذا رئاسة بلدية مو هاين عليه يتركها  شلون الرئاسة ؟ شو راح يسوي بال NUM ! والله ليصير الدم للركب	Iraq
--------	Palestine
TN	Tunisia
شكون كيفي ما تفرج في حتا حلقة من #gameofthrones و مستحمل أصحابو اللي نهار و طولو يحكيوا عليه	Tunisia
ان شاء اللٰه " علي الجمل " حارسنا اللي ماعندوش بديل في الترجي ، يكون خير حارس لعرين الدولة   #مربوحة_ان_شاءاللٰه #مكشخة  #الترجي_الوداد	Tunisia
المغرب : أنت و أدائك و زياش متاعدك ، و التسعة نقاط اللي ترشحتوا بيهم ، سفسريكم و باب عليوه متع مصر .	Libya
شكرا يعيشك لحقيقة اني ما عادش نشري كتب بالفرنسية و إلا بالإنجليزية خاتر غاليين برشا الكتاب الباهي أقل شي ب NUM د وليت نقرأ هم PDF	Tunisia
عكل يا انسه يا فاضله كان المفروض تحط حاجه عالتصويرة وعيب تهبطها هكا	Tunisia
---------	Palestine
AE	Palestine
احيانا كرة القدم تخليك تكرها . . راشد بالهول اهان الوصل كثير وضيع النادي هو وزبانيته اللي باذن الله نفتك منهم جريب ونحتفل	UAE
فالمستقبل القريب بتندمون على هذي الفضاوة ولعب الصغار اللي شغالين فيه الحين ولكم في سوريا وليبيا عبرة	UAE
ف ناس اترد ع تغريداتهم مرة و مرتين و ثلاث واكثر ولا يردون عليك . . حبيبي ع شو شايف نفسك يالطيب . . المشكله ما عنده متابعين عشان اتقول شايف نفسه لسبب . . هالاشكال ببدا اصفيهم	UAE
تخيل تنش الصبح و تشوف كريماتك ضايعه . . شو بتسوي حزتها ؟	UAE
وين الغلط لما اجنس لاعبين ممكن يضيفون للانديه والمنتخب اغلب الدول الاوروبيه جنست لاعبين واضافوا لدورياتهم ومنتخباتهم هذا الاحتراف ليش زيدان ما وصل فرنسا لكاس العالم وهو مجنس ! ؟ والا انتوا تاخذون من الاحتراف اللي تبونه واللي ماتبونه طاف	Kuwait
----------	Palestine
JO	Palestine
احلى اشي ، اصلا نبع الحنات لو تضرب بتعمل يومي وبصير احلى شي الله يحفظ امهاتنا كلنا	Palestine
بلغي عنه ل تويتر ابعتيلهم مسج القصص هاي صارت كتير مستفزه صايره معي تقريبا نفس القصه هاي الفتره بس ع مستوى اكبر بكتير من تويتر ووكلت محامي وفي قضيه عالطريق ، ، ، لا خجل ولا حياء قسما بالله	Palestine
اشي مقرف عنجد وبعدين بيدخل باسم فجاه ولو خو شي تاني بس انا الحساب الي بشوفه جديد والاسم فيك دغري بلوك	Palestine
انا شخصيا صرت مبسوطة لما صرت تابعك و احضر مسلسلاتك  حتى بالمدرسة  بالصف بحط السماعات بس مشان اسمع صوتك الحلوووو	Palestine
نزللنا كشف راتبك . الشهر الجاي . . مو مشان شي .  بس مشان الشفافيه يعنك	Kuwait
-----------	Palestine
LY	Palestine
سوق الجمعة يشكروا فيه , قالى نمشيله وفي اكثر من واحد معاه .	Libya
انا مانبيش نصدمك ونقولك اللي تلقحي عليه بالكلام مدايرلك ميوت ريحينا بئا	Libya
من الحاجات اللي كنت نشوف فيها صعبه جدا وهي انبطل نشرب المشروب الغازي ، بس توا ولت عندي حاجة عادية جدا ونستغرب كيف يشربوا فيه الناس ، المهم النقطه اللي نبي نوصلها ان لما الانسان يقتنع داخليا و يحاول بالاصرار يوصل ، مفيش شي صعب ومستحيل ، بس احني نخافوا من المواجهة بس ، فنقولوا صعب	Libya
مفروض يكسروله باقي صوابعه بيش يستمر على هالمستوى	Libya
تخايل ي نعمان انت نازل من دروج الطيارة تلقي الشرادم بطرحة جديدة قدام وجهك يستقبلو فيك بمصطلحات ياعمو ويا شيباني لا تقيس عليك بسو	Libya
---------------	Palestine
PL	Palestine
ابوي كل سنة بوزعها على العيلة والحبايب . . ما بضل حدا الا باكل منها . .	Palestine
انتي حسابك فاتحتي الك و لتتسلي فيه و تتواصلي مع الي بتحبيهم و بحبوكي  اي موقف او تصرف او رد من شخص برا نطاق اهتمامك غلط يأثر فيكي ويخليكي تلغي حسابك . .  حسابك خليه منفس الك وسيبك من اي شئ	Egypt
هلا كنت سايقة وبحكي تلفون الشرطي وقفني بدو يخالفني لما عرف انه بحكي مع الدكتور المشرف مشان توقيع الرسالة . . بطل يخالفني قال انا والماستر عليها	Kuwait
يا الله مو طايقة شي ولا طايقة حالي ولا طايقة حدا ولا حدا يا رب يا رب يااااا رب بس	Palestine
اكيد مافي اطيب وانضف من اكل البيت ، ، بس لما بنجتمع بنطلب اكل ، مش كل يوم بقدر اروح اتغدا بالبيت	Palestine
------------	Palestine
LB	Lebanon
حطو عداد ع مناخيرنا كرمال ما نتنفس . ...العمى بقلبكن واحد ورا التاني انشالله بتولعو كلكن سوا #صار_بدها_ثورة_المظلومين	Lebanon
أحلى مرشح والله ورئيس لائحة , , , بتسكر المجلس بالهضامة والجو الحلو	Lebanon
بس تروح بيروح الخير والحب والعاطفة من كل الدني الله يرحمك يا امي	Palestine
طلع جوزيف بو فاضل عصب محور المقاومة و الممانعة . . و قفولي هالمحور بدي انزل و كفي مع الكفار . .	Lebanon
بس يكون وفي متل الشهيد منرفعلو الشبو حبيبي بس م وصل لنقطة من الئيس الشهيد	Lebanon
-------------	Palestine
OM	Palestine
ماحد فعلا بس الي يصير لحين صار القتل شربت ماي	Kuwait
اذا كان الموضوع فيه خير ف نحن موجودين  اما اذا الموضوع الجديد القديم طائفيه وعنصرية ومذهبية هذة مخليها لكم  انتم اهلها هالسوالف	Oman
اللي ف الملعب يقدرو يحددو شو كان الحكم المساعد حسبها . ..لكن في اعاده مب واضحه كثير . ..انا شفت المساعد رفع بعد ما عدت الكوره المرمى ولكن ما شفت نزل الرايه	UAE
ترااه حظك هذي المره نفعك ولا هو م شي منه   اول مره تصدق حظي يطلع حلو ولا مبونه كما وجهي	Oman
جيت وخذيت السنين وذكريات السنين  ماكنت ضيف المحاني كنت راعي محل ! وأقفيت من دون سبه لكن الله يعين  منت أول اللي عطيته دم قلبي ورحل !	Kuwait
----------	Palestine
KW	Palestine
والجو يجيب الهم زياده وان تواصلت معاي تجيك جلطه	Libya
الحين هبة الدايركت اليديده بالسناب  يسمونه التحرش التكانه تدزله هالصوره قبل لا تصور نفسها عشان يعرف شكلها	Kuwait
شنو العفو الشامل بعد . .. وين العداله  اللي مارتكب جريمه ونسجن شنو بيستفيد ! ! !	Kuwait
ماهوو انتي شايفه طلع وي دار مادخلك شر . يلعن ابو الفلوس . لو كان فقير ماطلع يلعن بو الفقر	Kuwait
اليوم صارلي موقف غريب وعجيب ابيكم تسمعونه وتفكرون شنو سببه ووين نهايته	Iraq
---------	Palestine
QA	Palestine
يا أخوي أرفع راسك أنت ولد قابوس و بمجرد هو ينطق أسم عمان المفروض يوقف على حيله . . هذولا متربية مجاري ومن ناحية قطر وأهلها مطوعين الصعايب دقوا خشومهم دق و قطر تصعب على من بغاها	Qatar
تلفون مكتبي خربان من اسبوعين كل ما اكلم الاي تي يجون يغيرونه يتعدل  والله احس يحسبوني كذابة	Qatar
يبه ماااااانبي نحج غصب !  حكومتنا مالها شغل احنا كشعب واعي على خياناتكم وغدركم مانقدر نستأمن نفوسنا في قعر داركم  لم يمنعنا احد قراراتنا في عدم الذهاب للحج هي من روسنا	Qatar
#نادي_الريان_ارهابي صديقاتي الريانيات ها انشر اساميكم عشان تدخلون المجد  ترى عدد منهم من البحرين شلون عليهم معاهم والا ؟ !	Qatar
لا العقول مب ضعيفه مثل ما تحطون التسجيلات و مبسوطين عليها من حقنا بعد ما وضحنا اسبابها تروونا ادلتكم اللي مستندين عليها في الاساءه لدولتي قطر ورموزها من حقنا معرفة الاسباب	Qatar
--------	Palestine
BH	Palestine
اذبح روحي واحترم وقت الأولي والتالي واسوي لي جدول وحاله . . بس وين اللي يقدر ؟	Kuwait
ي ليل م اطولك لجيتونا ترى القضيه مش قضيه فلوس تعبت اقول في اتهامات على اميركم انه يدعم الارهاب فتحوا مخكم وافهموا شوي	Egypt
احنا لو ناخذ المركز الثالث بنروح الدوري الاوروبي  اما انتو اذا خذتو المركز الثالث وين بتروحون ؟ !	Qatar
البحريني اذا عجبه أكل من مطعم قال : بووو عجييب ، جنه شغل بيت ، ، واذا عجبه أكل بيت قال : والله روعة ، جنه مال مطاعم ! !   #انفصام_شخصيه  #شسالفه	Kuwait
مشكله للحين في ناس وايد برغم شهاداتهم وثقافاتهم تلاقينهم متخلفين بهالشي وعايشين عالعنصريه والتفرقه .	Kuwait
